180
147
164
168
153
159
163
183
157
Lines drawn: 8
Zones: 9
Ideal people per zone is 163.777777778
Error (sum of the absolute value of the deviation from the ideal population in each zone) is:  79.7777777778

8 0 6 1 0 4 0 0 8 8 8 2|4 8 5 3|4 8 7 4
                       |       |       
5 7 0 3 6 1 0 7 1 1 1 1|2 5 6 4|5 1 5 0
                       |       |       
3 0 5 8 8 7 6 5 1 4 3 1|2 6 0 4|7 5 1 5
                       |       |       
1 7 2 0 4 6 1 6 2 2 0 3|3 5 6 8|7 4 4 0
-----------------------|       |       
6 7 6 7 0 6 1 3 6 8 0 2|0 4 0 3|6 1 0 7
                       |       |       
8 6 7 6 5 8 5 5 5 2 0 3|6 1 4 2|8 2 7 0
                       |       |       
0 6 0 6 5 8 1 2 7 6 3 1|0 3 0 4|0 1 0 5
-----------------------|       |       
5 5 7 4 3 0 0 5 0 0 8 1|1 8 7 2|8 0 0 8
                       |       |       
2 4 0 5 6 7 0 5 6 3 8 1|2 5 3 3|1 8 3 7
                       |       |       
0 7 6 6 2 8 3 4 6 8 4 6|2 5 7 0|3 1 2 1
                       |       |       
0 3 6 4 0 4 0 6 0 3 4 8|2 3 3 8|0 6 1 0
---------------------------------------
7 2 6 5 4 5 8 6 4 4|1 1 2 3|1 0 0 8 0 0
                   |       |           
6 7 3 6 2 6 5 0 2 7|7 2 7 0|4 0 0 6 3 6
                   |       |           
8 0 0 5 0 0 1 4 2 6|7 1 7 8|1 6 2 7 0 0
                   |       |           
8 4 7 1 7 5 6 2 5 2|8 5 7 7|8 2 3 1 5 7
-------------------|       |           
7 2 8 1 1 0 1 0 1 3|8 7 7 5|2 6 3 0 5 5
                   |       |           
1 2 0 1 6 6 0 4 6 7|0 5 0 0|5 5 7 0 7 7
                   |       |           
7 7 3 6 0 1 5 8 5 8|7 0 0 0|4 0 2 1 3 4
                   |       |           
4 3 0 6 5 1 0 6 2 0|6 5 5 7|8 2 0 4 3 4
                   |       |           
4 1 0 4 6 0 6 4 3 2|2 6 2 2|7 3 6 3 0 4
